14 14
GGGGGGGGGGGGGG
LLLRRRRRRRRRRR
GGGGGGGGGGGGGG
RRRRRRRRRRRRRR
RRRRRRRRRRRLLL
LLLGGGGGGGGGGG
RRRRRRRRRRRRRR
LLLLLLLLLLLLLG
RRRRRRRRRRRRRR
LLLLLLGGGLLLLL
RRRRRRRRRRRRRR
GGGGGGGGGGGGGG
RRRRRRRRRRRRRR
GGGGGGGGGGGGFG
7
N L 12
S R 10
F R 8
N L 6
B 1 3 4 0 8 R
S L 3
B 1 2 1 0 10 L
