15 15
LLLLLLLGLLLLLLL
RRRRRRRRRRRRRRR
GGLLLLLLLLLLLGG
RRRRRRRRRRRRRRR
GGGGGGGGGGGGGGG
RRRRRRRRRRRRRRR
RRRRRRRRRRRRRRR
RRRRRRRRRRRRRRR
GGGGGGGGGGGGGGG
RRRRRRRLRRRRRRR
GGGGGGGGGGGGGGG
LLGGGGGGGGGGGLL
RRRRRRRRRRRRRRR
RRRRRRRRRRRRRRR
GGGGGGGFGGGGGGG
9
F R 1
N L 3
N R 5
F L 6
S R 7
B 1 2 9 0 10 R
B 1 2 9 13 10 L
S R 12
F R 13

