10 13
GGGGGGGGGGGGG
RRRRRRRRRRRLR
RRRRRRRRRRRRR
GGGGGGGGGGGGG
RRRRRRRRRRRRR
RRRRRRRRRRRRR
GGGGGGGGGGGGG
GGGGGGGGGGGGG
RRRRRRRRRRRRR
GGGGGGGGGGGGF
5
B 1 3 1 5 6 R
F L 8
N R 5
N L 4
S R 2
